bitmap_index,sx,sy,sw,sh,ox,oy,notes
0,0,0,105,173,0,0,
0,105,0,208,208,9,-5,
0,313,0,291,293,1,5,
0,604,0,417,450,-3,0,
0,1021,0,476,528,0,-9,
0,1497,0,504,577,-3,-3,
0,0,450,625,580,31,5,
0,625,528,691,488,32,-1,
0,0,1030,756,503,17,-4,
0,756,1016,509,445,16,-14,
0,1265,1016,384,510,-29,27,
